##########
#S#......#
#.#.####.#
#.#....#.#
#.####.#G#
#........#
##########
