##########
#S#......#
#.#.#.##.#
#.#.#.#G.#
#...#.#..#
#######..#
##########
