##########
#S#.....G#
#.#.####.#
#.#....#.#
#.#.##.#.#
#........#
##########
